1 2 1674 1676 
1 7 3544 11492 548 11515 3381 17 6558 
1 7 6558 3532 444 3473 9496 11505 13292 
1 5 362 389 3324 243 11515 
1 8 11542 6440 11432 6559 514 6441 3499 6521 
1 2 13292 6521 
1 3 6282 537 9496 
1 10 6287 6393 3260 3325 11251 317 6389 11331 11305 321 
1 5 321 11276 11219 375 6521 
1 2 11305 11276 
1 5 394 6235 3341 3277 11251 
